--------------------------------------------------------------------------------
---****---*---*-----------------------------------------------------------------
--------------------------------------------------------------------------------
--**************-**********************-%@%@@@@*******************************--
--***********%**####**##**##**##*##*%*-%@@%@@@@@***%****##**##**##**##%***#***--
--**************--**-***-***-***-**--**-@@%@@@@****-**--**-***-***-***-**-****--
--***********#***%**%%**%***%***%***%**%@@%@@@@@***%***%**#%**%#**%***%***#***--
--**************-***********************%@%@%@@%*************************-****--
--***********#**************************%@%@@@@%******************************--
--**************-**********************#@@@@@@%%*************************-****--
--**********************************#***@%@@@@@@%%%%%%%%%%%%%%%%%%%%%%#*******--
--**************-*********************-:@@@@@@@@@@@@@@@@@@@@@@@@@@@@@@***-****--
--************##********************#--*@@@@@%@@@@@@@@%@%@@@@@@@@@@@@@#*#*****--
--**************-*-*-*-*-**********-**-:-**-*-*--*****-*%%@%@%@@@@@@@@***-****--
--***********#*-********************%-********************************#*-*****--
--*************-+*********************-+********************************-+****--
--*************-*********************--*********************************-*****--
--*************--*********************--********************************--****--
--*************--********************---********************************--****--
--*************--*********************--********************************--****--
--*************--***#*****************--********************************--****--
--*************---*-*-*-*-*-****-*--**+*********************************--****--
--************---*#*******************#*#******#@@@@@@@@@@@%@%@@@@@@@@*---****--
--*************+********#**********************#@@@@@@@@@%@@@%@@@%@@@@#*--****--
--************--+**********##**#***#***#*******#%@@@@@@@@%@%@%@@@@@@@@*--+****--
--*************-*******************************#@@@@@@@%%%@%@%%%%%%%%%#*--****--
--*************-+******************************%@@@@@@@****************--+****--
--*************-*#***#******************#*******#*#%#*#*****************-*****--
--*************-+-*-+-*--***************-*------*-+-*-+*****************-+****--
--*****************-***-******************-********#**************************--
--**************-*******************************@@@@@@@******************-****--
--************##*******************************#@@@@@@@*****************#*****--
--**************-******************************#%@@@@@@******************-****--
--************%@********#@@%%%@@%%@@@@%%@@%@@@@@@@@@@@@****************#@*****--
--**************-********@@@@@@@@@@@@@@@@@@@@@@@@@@@@@@******************-****--
--************#@********#@@@@@@@@@@@@@@@@@@@@@@@@@@@@@@*****************@*****--
--**********************#%@@@@@@@@@@@@%@@@@@@@@@@@@%@@@***********************--
--*************%-*******#@@@@@@@#***************************************%*****--
--**********************#%@@@@@@#*********************************************--
--*************#-*****#*#%@@@@%%#**********#************#*#*#*#*********#*****--
--***************-*--****---****-*--****-*-*-*-*-**-*-*-*-*-*-*-*-*-**********--
--*************#-*******#%@@@@@@@@@@@@%@@@@@@@@@@@@@@@@@@%@%@%@@@@@@@@**#*****--
--***********#*-*#******#%@@@@@@@@@@@@%@@@@@%@@@@@@@@@@@@%@%@%@@@@@@@@@***#***--
--**************-***#***#%@@@@@@@@%@@@%@%@%@%@@@@@@@@@@@@%@%@%@%@@@@@@********--
--***********%***#******#%%%%%%%%%%%%@%@%@%%%%%%%%%%%%@%@%@%@%@%@%@@@@@***#***--
--**************-**********************************************@@@@@@@***-****--
--***********#***#***#******#***#***#***#***#******************@@@@@@@%*******--
--**************--*-+-*------*-+-*-+-*-+-*-+----*************************-****--
--*****************-***-**********-***-***-***************************#*******--
--**************-**********************************************@@@@@@@***-****--
--************##***********************************************@@@@@@@###*****--
--**************-**********************************************@@@@@@@***-****--
--************%@*%%@%%%@%%%@%%@@%%@@%%%%%%@@%%@@%%%@%@@@%@%@%@%@@@@@@@##@*****--
--**************-%@@@@@@@@@@@@@@@@@@@@@@%%@@@@@@@@@@@@@@@@@@@@@@@@@@@@***-****--
--************#@*%%@%@%@%%%@@@@@@@@%****@%@%@%@@@%%%%%%@%@%@%@%@%@%%%%*#@*****--
--***************--*-*-**%%@@@@@@@@@***--**-*-*--*****---*-*-*--**************--
--*************--***********************@@@@@@@%************************--****--
--*************--***********************@@@@@@@%************************--****--
--*************--***********************%@@@@@@%************************--****--
--*************--*#*********************%@%@@@@%#***********************--****--
--************---***********************%@%@@@@%***********************---****--
--*************+*********************#**%@%@%@@%***************#********--****--
--***********----******************#***#%@%@%@@%*****************##****--+***#--
--*************+*****************##**##*%@%@%@%%****************#***#***--****--
--************--+-**-***-***-***-**--**-***********-**--**-***-***-***---+****--
--*************-*#**%%**%***%***%***%**************#***%**#%**%#**%***#*-*****--
--*************-+*#********************-********************************-+****--
--***********#*-********************************************************-*****--
--*************-+**********************-********************************-+****--
--***********#*-*********************#********************************#*-*****--
--*************-:**********************-********************************-+****--
--------------------------------------------------------------------------------
--------------------------------------------------------------------------------